F	 		 72, 			  72,		72   	
NO 		 	 ./images/Ground_01.png			
EA   		./images/Ground_04.png	 	 	
SO   		 ./images/Ground_02.png   
C 		  102,	  153,			  	255 	 	
WE 		./images/Ground_03.png 	 	 	
		1111111111111111111111111
		1000000000110000000000001
		1011000001110000000000001
        1001000000000000000000001
111111111011000001110000000000001
100000000011000001110111111111111
11110111111111011100000010001
11110111111111011101010010001
11000000110101011100000010001
100000000000 0001100000000001
10000000000000001101010010001
110000011101010111110111E0111
11110111 1110101 101111010001
11111111 1111111 111111111111



